Līdzatkarībai	līdzatkarība	ncfsd4
ir	būt	vcnipii30an
vairākas	vairākas	pi3fpnn
definīcijas	definīcija	ncfpn4
.	.	zs
Pēc	pēc	spsgy
pusstundas	pusstunda	ncfsg4
var	varēt	vonipt330an
ķerties	ķerties	vmyn0i1000n
pie	pie	spsgy
pedikīra	pedikīrs	ncmsg1
veikšanas	veikšana	ncfsg4
.	.	zs
Mute	mute	ncfsn5
jāvirina	virināt	vmnd0t300an
vien	vien	qs
būs	būt	vcnifii30an
!	!	zs
"	"	zq
Tikko	tikko	r0t
kā	kā	qs
no	no	spsgy
bērnunama	bērnunams	ncmsg1
.	.	zs
Aprīlī	aprīlis	ncmsl2
plānota	plānot	vmnpdfsnpsn
Ogres	Ogre	npfsg5
Slēpotāju	slēpotājs	ncmpg1
Kluba	klubs	ncmsg1
sapulce	sapulce	ncfsn5
,	,	zc
kurā	kurā	pr0fsln
atskatīsimies	atskatīties	vmyifi31pan
uz	uz	spsay
pagājušo	paiet	vmnpdmsaasy
sezonu	sezona	ncfsa4
un	un	ccs
domāsim	domāt	vmnift21pan
par	par	spsan
nākošo	nākt	vmnpdfsaapy
.	.	zs
Celtniecībai	celtniecība	ncfsd4
atvēlēti	atvēlēt	vmnpdmpnpsn
680	680	xn
000	000	xn
latu	lats	ncmpg1
.	.	zs
—	—	zd
Vai	vai	qs
jums	jums	pp20pdn
Eiropa	Eiropa	npfsn4
palīdz	palīdzēt	vmnipt330an
?	?	zs
Viss	viss	pi0msnn
tiek	tikt	vtnipi130an
paveikts	paveikt	vmnpdmsnpsn
pašu	pašu	pg0mpgn
spēkiem	spēks	ncmpd1
,	,	zc
neizmantojot	neizmantot	vmnpu000000
starpniekus	starpnieks	ncmpa1
.	.	zs
Bet	bet	ccs
,	,	zc
pēc	pēc	sppdy
Rīgas	Rīga	npfsg4
Pedagoģijas	pedagoģija	ncfsg4
un	un	ccs
izglītības	izglītība	ncfsg4
vadības	vadība	ncfsg4
augstskolas	augstskola	ncfsg4
rektores	rektore	ncfsg5
Daces	Dace	npfsg5
Markus	Markus	npfsg6
domām	doma	ncfpd4
,	,	zc
ja	ja	css
samazināsies	samazināties	vmyifi330an
attiecība	attiecība	ncfsn4
starp	starp	spsay
profesoru	profesors	ncmpg1
uz	uz	spsgy
zemāka	zems	afmsgnc
līmeņa	līmenis	ncmsg2
mācībspēku	mācībspēks	ncmpg1
algām	alga	ncfpd4
,	,	zc
tas	tas	pd3msnn
radīs	radīt	vmnift330an
sociālo	sociāla	arfsayp
spriedzi	spriedze	ncfsa5
augstskolās	augstskola	ncfpl4
.	.	zs
Minētā	minēt	vmnpdfsnpsy
norma	norma	ncfsn4
nav	būt	vcnipii30ay
obligāta	obligāta	arfsnnp
prasība	prasība	ncfsn4
,	,	zc
kura	kura	pr0fsnn
ES	es	pp10snn
dalībvalstīm	dalībvalsts	ncfpd6
būtu	būt	vcnc0ii00an
noteikti	noteikti	r0q
jāievieš	ieviest	vmnd0t100an
,	,	zc
taču	taču	ccs
Latvija	Latvija	npfsn4
izmanto	izmantot	vmnipt230an
šo	šo	pd3fsan
iespēju	iespēja	ncfsa4
.	.	zs
Jau	jau	r0t
ziņots	ziņot	vmnpdmsnpsn
,	,	zc
ka	ka	css
trešdien	trešdien	r0t
notikušajā	notikt	vmnpdfslasy
kvalifikācijā	kvalifikācija	ncfsl4
latvietis	latvietis	ncmsn2
jau	jau	r0t
pirmajā	pirmais	mosmslv
mēģinājumā	mēģinājums	ncmsl1
rīku	rīks	ncmsa1
raidīja	raidīt	vmnist330an
67	67	xn
,	,	zc
30	30	xn
metrus	metrs	ncmpa1
tālu	tālu	r0p
,	,	zc
izpildot	izpildīt	vmnpu000000
kvalifikācijas	kvalifikācija	ncfsg4
normu	norma	ncfsa4
.	.	zs
Taču	taču	ccs
valdība	valdība	ncfsn4
nolēmusi	nolemt	vmnpdfsnasn
prasīt	prasīt	vmnn0t3000n
pacienta	pacients	ncmsg1
iemaksu	iemaksa	ncfsa4
arī	arī	qs
no	no	sppdy
trūcīgām	trūcīga	affpdnp
personām	persona	ncfpd4
,	,	zc
kas	kas	pr000nn
iepriekš	iepriekš	r0t
saprotamu	saprast	vmnpdmpgppn
iemeslu	iemesls	ncmpg1
dēļ	dēļ	stpgy
no	no	sppdy
maksājumiem	maksājums	ncmpd1
bija	būt	vcnisii30an
atbrīvotas	atbrīvot	vmnpdfpnpsn
.	.	zs
Atsavināts	atsavināt	vmnpdmsnpsn
ievērojams	ievērot	vmnpdmsnppn
daudzums	daudzums	ncmsn1
dažādu	dažāda	arfpgnp
narkotiku	narkotika	ncfpg4
,	,	zc
portālu	portāls	ncmsa1
«	«	zq
Apollo	Apollo	x_
»	»	zq
informēja	informēt	vmnist230an
Valsts	valsts	ncfsg6
policijas	policija	ncfsg4
pārstāve	pārstāve	ncfsn5
Sintija	Sintija	npfsn4
Virse	Virse	npfsn5
.	.	zs
NATO	NATO	x_
dalībvalstīm	dalībvalsts	ncfpd6
būtu	būt	vcnc0ii00an
jāpiedāvā	piedāvāt	vmnd0t200an
Gruzijai	Gruzija	npfsd4
Dalības	dalība	ncfsg4
rīcības	rīcība	ncfsg4
plāns	plāns	afmsnnp
,	,	zc
jo	jo	css
tas	tas	pd3msnn
šai	šai	pd3fsdn
valstij	valsts	ncfsd6
pavērtu	pavērt	vmnc0t100an
iespēju	iespēja	ncfsa4
īstenot	īstenot	vmnn0t2000n
reformas	reforma	ncfpa4
un	un	ccs
drīzāk	drīzāk	r0t
atrisināt	atrisināt	vmnn0t3000n
«	«	zq
iesaldētos	iesaldēt	vmnpdmplpsn
konfliktus	konflikts	n_mpa1
»	»	zq
,	,	zc
»	»	zq
rakstījis	rakstīt	vmnpdmsnasn
Lietuvas	Lietuva	npfsg4
prezidents	prezidents	ncmsn1
.	.	zs
Vēl	vēl	r0t
vairāk	vairāk	rcq
,	,	zc
daudzas	daudzas	pi0fpnn
pazīmes	pazīme	ncfpn5
liecina	liecināt	vmnipt330an
,	,	zc
ka	ka	css
planēta	planēta	ncfsn4
jau	jau	r0t
tagad	tagad	r0t
to	to	pd3msan
pārdzīvo	pārdzīvot	vmnipt230an
:	:	zo
par	par	sppdn
pirmajiem	pirmais	mosmpdv
izmiršanas	izmiršana	ncfsg4
«	«	zq
perēkļiem	perēklis	ncmpd2
»	»	zq
riskē	riskēt	vmnipt230an
kļūt	kļūt	vtnn0i1000n
Austrālija	Austrālija	npfsn4
,	,	zc
Jaunzēlande	Jaunzēlande	npfsn5
un	un	ccs
Klusā	kluss	afmsgyp
okeāna	okeāns	ncmsg1
salas	sala	ncfpn4
,	,	zc
brīdina	brīdināt	vmnipt330an
ekologi	ekologs	ncmpn1
.	.	zs
Materiālos	materiāls	ncmpl1
zaudējumus	zaudējums	ncmpa1
un	un	ccs
ugunsgrēka	ugunsgrēks	ncmsg1
izcelšanās	izcelšana	ncfsgr
iemeslu	iemesls	ncmsa1
noskaidro	noskaidrot	vmnipt230an
.	.	zs
Mirstības	mirstība	ncfsg4
vispārējais	vispārējs	armsnyp
koeficients	koeficients	ncmsn1
-	-	zd
14	14	xn
,	,	zc
5	5	xn
mirušie	mirt	vmnpdmpnasy
uz	uz	sppdy
1000	1000	xn
iedzīvotājiem	iedzīvotājs	ncmpd1
-	-	zd
praktiski	praktiski	rpm
saglabājies	saglabāties	vmyipi23san
iepriekšējā	iepriekšējs	armsgyp
gada	gads	ncmsg1
līmenī	līmenis	ncmsl2
.	.	zs
Pieredze	pieredze	ncfsn5
rāda	rādīt	vmnipt330an
,	,	zc
ka	ka	css
viltotajās	viltot	vmnpdfplpsy
zālēs	zāle	ncfpl5
ne vien	ne vien	ccd
nav	būt	vmnipii30ay
aktīvās	aktīva	affpnyp
vielas	viela	ncfpn4
,	,	zc
bet	bet	ccd
pat	pat	qs
mēdz	mēgt	vonipt130an
būt	būt	vmnn0t1000n
toksiskas	toksiska	arfpnnp
sastāvdaļas	sastāvdaļa	ncfpn4
.	.	zs
Tu	tu	pp20snn
neesi	nebūt	vcnipii2say
laimīga	laimīga	affsnnp
!	!	zs
"	"	zq
Ko	ko	pq000an
mēs	mēs	pp10pnn
ar	ar	sppdn
šīm	šīm	pd3fpdn
vārītajām	vārīt	vmnpdfpdpsy
olām	ola	ncfpd4
darījām	darīt	vmnist31pan
,	,	zc
pilnīgi	pilnīgi	r0q
skaidri	skaidri	rpm
neatceros	neatcerēties	vmyipi31say
,	,	zc
droši vien	droši vien	qc
slēpām	slēpt	vmnist11pan
skolotāju	skolotājs	ncmpg1
somās	soma	ncfpl4
.	.	zs
Jau	jau	r0t
pērn	pērn	r0t
izlases	izlase	ncfsg5
rindās	rinda	ncfpl4
parādījās	parādīties	vmyisi330an
jauni	jauns	afmpnnp
vārdi	vārds	ncmpn1
,	,	zc
tagad	tagad	r0t
ir	būt	vmnipii30an
vēl	vēl	r0t
jauni	jauns	afmpnnp
,	,	zc
turklāt	turklāt	css
vēl	vēl	r0t
daži	daži	pi0mpnn
futbolisti	futbolists	ncmpn1
(	(	zb
gados	gads	ncmpl1
jauni	jauns	afmpnnp
!	!	zs
)	)	zb
,	,	zc
kas	kas	pr000nn
sevi	sevi	px000an
labi	labi	rpm
parādīja	parādīt	vmnist330an
LMT	LMT	x_
virslīgas	virslīga	ncmsg4
spēlēs	spēle	ncfpl5
,	,	zc
ir	būt	vmnipii30an
Aleksandra	Aleksandra	npmsg1
Starkova	Starkovs	npmsg1
un	un	ccs
viņa	Vilis	npmsg2
palīgu	palīgs	ncmpg1
tuvākajā	tuvs	afmslyc
redzeslokā	redzesloks	ncmsl1
.	.	zs
Otrās	otrā	mosfpnv
laulības	laulības	ncfpn4
tas	tas	pd3msnn
jau	jau	r0t
ir	būt	vcnipii30an
cits	cits	pi0msnn
stāsts	stāsts	ncmsn1
.	.	zs
A	A	y
.	.	zs
Upīša	Upītis	npmsg2
Skrīveru	Skrīveris	npmpg2
vidusskolā	vidusskola	ncfsl4
notika	notikt	vmnisi130an
audzēkņu	audzēknis	ncmpg2
ierindas	ierinda	ncfsg4
skate	skate	ncfsn5
.	.	zs
Iedzīvotājiem	iedzīvotājs	ncmpd1
bija	būt	vcnisii30an
iespēja	iespēja	ncfsn4
uzdot	uzdot	vmnn0t2000n
Valsts	valsts	ncfsg6
prezidentam	prezidents	ncmsd1
aktuālus	aktuāls	afmpanp
jautājumus	jautājums	ncmpa1
un	un	ccs
stāstīt	stāstīt	vmnn0t3000n
par	par	sppdn
lietām	lieta	ncfpd4
,	,	zc
kuras	kuras	pr0fpnn
viņus	viņus	pp3mpan
uztrauc	uztraukt	vmnipi130an
.	.	zs
Uzskatot	uzskatīt	vmnpu000000
,	,	zc
ka	ka	css
liellopu	liellopi	ncmpg1
gaļas	gaļa	ncfsg4
kvalitāti	kvalitāte	ncfsa5
nosaka	nosacīt	vmnipt330an
nokautā	nokaut	vmnpdmsgpsy
dzīvnieka	dzīvnieks	ncmsg1
dzimums	dzimums	ncmsn1
un	un	ccs
vecums	vecums	ncmsn1
,	,	zc
gaļīgums	gaļīgums	ncmsn1
un	un	ccs
tauku	tauki	ncmpg1
noslāņojums	noslāņojums	ncmsn1
,	,	zc
pētījumi	pētījums	ncmpn1
šajos	šajos	pd3mpln
virzienos	virziens	ncmpl1
veikti	veikt	vmnpdmpnpsn
pa	pa	sppdy
atsevišķām	atsevišķa	arfpdnp
gaļas	gaļa	ncfsg4
liellopu	liellopi	ncmpg1
šķirnēm	šķirne	ncfpd5
un	un	ccs
krustojumadzīvniekiem	krustojumadzīvnieks	ncmpd1
.	.	zs
Tāpēc	tāpēc	r0c
,	,	zc
viena	viens	mcsmsgv
optimālā	optimāls	armsgyp
atrisinājuma	atrisinājums	ncmsg1
vietā	vieta	ncfsl4
tiek	tikt	vtnipi130an
piedāvāts	piedāvāt	vmnpdmsnpsn
izmantot	izmantot	vmnn0t2000n
Pareto	Pareto	np___0
optimālo	optimāls	armpgyp
atrisinājumu	atrisinājums	ncmpg1
kopas	kopa	ncfsg4
jēdzienu	jēdziens	ncmsa1
.	.	zs
Piemēram	piemērs	ncmsd1
,	,	zc
plānojot	plānot	vmnpu000000
nepieciešamo	nepieciešams	afmpgyp
skolotāju	skolotājs	ncmpg1
skaitu	skaits	ncmsa1
Floridā	Florida	npfsl4
laika	laiks	ncmsg1
periodam	periods	ncmsd1
līdz	līdz	sppdy
2016	2016	xn
.	.	zs
gadam	gads	ncmsd1
,	,	zc
izglītības	izglītība	ncfsg4
departaments	departaments	ncmsn1
ņem	ņemt	vmnipt130an
vērā	vērā	r0p
2006	2006	xn
.	.	zs
gada	gads	ncmsg1
decembrī	decembris	ncmsl2
notikušās	notikt	vmnpdfpaasy
konferences	konference	ncfpa5
par	par	spsan
skolēnu	skolēns	ncmpg1
skaita	skaits	ncmsg1
noteikšanu	noteikšana	ncfsa4
lēmumos	lēmums	ncmpl1
paredzēto	paredzēt	vmnpdfsapsy
vidējā	vidējs	armsgyp
klases	klase	ncfsg5
lieluma	lielums	ncmsg1
samazināšanos	samazināšanās	ncfsar
.	.	zs
